NO ./image/no.xpm
SO ./image/so.xpm

WE ./image/we.xpm
EA ./image/ea.xpm

F 250,5,56
C 50,56,222

111111111111111111111111111111111
100000000000000000000000000000001
10000000000000000000000000000000111111
1000000000000000000000000S000000000001
10000000000000000000000000000000000001
11111111111111111111111111111111111111